Filename,Normal ,Abnormal,Normal Frames,Abnormal Frames,Total Frames
049_video.mp4,"Frame-1,Frame-2,Frame-3,Frame-4,Frame-5,Frame-6,Frame-7,Frame-8,Frame-9,Frame-10,Frame-11,Frame-12,Frame-13,Frame-18,Frame-19,Frame-24,Frame-25,Frame-26,Frame-28,Frame-29,Frame-30,Frame-31,Frame-32,Frame-33","Frame-14,Frame-15,Frame-16,Frame-17,Frame-20,Frame-21,Frame-22,Frame-23,Frame-27",24,9,33
050_video.mp4,"Frame-1,Frame-2,Frame-3,Frame-4,Frame-5,Frame-6,Frame-7,Frame-8,Frame-9,Frame-10,Frame-11,Frame-12,Frame-13,Frame-14","Frame-15,Frame-16,Frame-17,Frame-18,Frame-19,Frame-20,Frame-21,Frame-22,Frame-23,Frame-24,Frame-25,Frame-26",14,12,26
051_video.mp4,"Frame-1,Frame-2,Frame-3,Frame-4,Frame-5,Frame-6,Frame-7,Frame-8,Frame-9,Frame-10,Frame-11,Frame-12,Frame-13","Frame-14,Frame-15,Frame-16,Frame-17,Frame-18,Frame-19,Frame-20,Frame-21,Frame-22,Frame-23,Frame-24,Frame-25,Frame-26,Frame-27,Frame-28,Frame-29,Frame-30,Frame-31,Frame-32",13,19,32
052_video.mp4,"Frame-1,Frame-2,Frame-3,Frame-4,Frame-5,Frame-6,Frame-7,Frame-8,Frame-9,Frame-10,Frame-20,Frame-21,Frame-22,Frame-23,Frame-24,Frame-25,Frame-26,Frame-27,Frame-28,Frame-29,Frame-30","Frame-11,Frame-12,Frame-13,Frame-14,Frame-15,Frame-16,Frame-17,Frame-18,Frame-19",21,9,30
053_video.mp4,"Frame-1,Frame-2,Frame-3,Frame-4,Frame-5,Frame-6,Frame-7,Frame-8,Frame-9,Frame-10,Frame-11,Frame-12,Frame-13,Frame-14,Frame-15,Frame-16,Frame-17,Frame-21,Frame-29,Frame-30,Frame-31,Frame-32,Frame-33","Frame-18,Frame-19,Frame-20,Frame-22,Frame-23,Frame-24,Frame-25,Frame-26,Frame-27,Frame-28",23,10,33
054_video.mp4,"Frame-1,Frame-2,Frame-3,Frame-4,Frame-5,Frame-6,Frame-7,Frame-8,Frame-9,Frame-10,Frame-11,Frame-12,Frame-13,Frame-14,Frame-15,Frame-16,Frame-17,Frame-18,Frame-19,Frame-20,Frame-21,Frame-22,Frame-23,Frame-24,Frame-25,Frame-26,Frame-27,Frame-28",,28,0,28
055_video.mp4,"Frame-1,Frame-2,Frame-3,Frame-4,Frame-5,Frame-6,Frame-7,Frame-8,Frame-9,Frame-10,Frame-11,Frame-12,Frame-13,Frame-14,Frame-15,Frame-16,Frame-17,Frame-18,Frame-19,Frame-20,Frame-21,Frame-22,Frame-23,Frame-24,Frame-25,Frame-26,Frame-27,Frame-28,Frame-29,Frame-30,Frame-31,Frame-32",,32,0,32
056_video.mp4,"Frame-1,Frame-2,Frame-3,Frame-4,Frame-5,Frame-6,Frame-7,Frame-8,Frame-9,Frame-10,Frame-11,Frame-12,Frame-13,Frame-14,Frame-15,Frame-16,Frame-17,Frame-18,Frame-19,Frame-20,Frame-21,Frame-22,Frame-23,Frame-24,Frame-25,Frame-26,Frame-27,Frame-28,Frame-29,Frame-30,Frame-31,Frame-32,Frame-33",,33,0,33
057_video.mp4,"Frame-1,Frame-2,Frame-3,Frame-4,Frame-5,Frame-6,Frame-7,Frame-8,Frame-9,Frame-10,Frame-11,Frame-12,Frame-13,Frame-14,Frame-15,Frame-16,Frame-17,Frame-18,Frame-19,Frame-20,Frame-21,Frame-22,Frame-23,Frame-24,Frame-25,Frame-26,Frame-27,Frame-28,Frame-29,Frame-30,Frame-31,Frame-32,Frame-33,Frame-34,Frame-35",,35,0,35
058_video.mp4,"Frame-1,Frame-2,Frame-3,Frame-4,Frame-5,Frame-6,Frame-7,Frame-8,Frame-9,Frame-10,Frame-11,Frame-12,Frame-15,Frame-16,Frame-17,Frame-18,Frame-19,Frame-20,Frame-21,Frame-22,Frame-23,Frame-24,Frame-25,Frame-26,Frame-27,Frame-28,Frame-29,Frame-30,Frame-31,Frame-32,Frame-33,Frame-34","Frame-13,Frame-14",32,2,34
059_video.mp4,"Frame-1,Frame-2,Frame-3,Frame-4,Frame-5,Frame-6,Frame-7,Frame-8,Frame-9,Frame-10,Frame-11,Frame-12,Frame-13,Frame-14,Frame-15,Frame-16,Frame-17,Frame-18,Frame-19,Frame-20,Frame-21,Frame-22,Frame-23,Frame-24,Frame-25,Frame-26,Frame-27",,27,0,27
060_video.mp4,"Frame-1,Frame-2,Frame-3,Frame-4,Frame-5,Frame-6,Frame-7,Frame-8,Frame-9,Frame-10,Frame-11,Frame-12,Frame-13,Frame-14,Frame-15,Frame-16,Frame-17,Frame-18,Frame-19,Frame-20,Frame-21,Frame-22,Frame-23,Frame-24,Frame-25,Frame-26,Frame-27,Frame-28,Frame-29",,29,0,29
061_video.mp4,"Frame-1,Frame-2,Frame-3,Frame-4,Frame-5,Frame-6,Frame-7,Frame-8,Frame-9,Frame-10,Frame-11,Frame-12,Frame-13,Frame-14,Frame-15,Frame-16,Frame-17,Frame-18,Frame-19,Frame-20,Frame-21,Frame-22,Frame-23,Frame-24,Frame-25,Frame-26,Frame-27,Frame-28,Frame-29,Frame-30,Frame-31",,31,0,31
062_video.mp4,"Frame-1,Frame-2,Frame-3,Frame-4,Frame-5,Frame-6,Frame-7,Frame-8,Frame-9,Frame-10,Frame-11,Frame-12,Frame-13,Frame-14,Frame-15,Frame-16,Frame-17,Frame-18,Frame-19,Frame-20,Frame-21,Frame-22,Frame-23",,23,0,23
063_video.mp4,"Frame-1,Frame-2,Frame-3,Frame-4,Frame-5,Frame-6,Frame-7,Frame-8,Frame-9,Frame-10,Frame-11,Frame-12,Frame-13,Frame-14,Frame-15,Frame-16,Frame-17,Frame-18,Frame-19,Frame-20,Frame-21,Frame-22,Frame-23,Frame-24,Frame-25,Frame-26,Frame-27,Frame-28,Frame-29,Frame-30,Frame-31,Frame-32,Frame-33,Frame-34,Frame-35,Frame-36",,36,0,36
064_video.mp4,"Frame-1,Frame-2,Frame-3,Frame-4,Frame-5,Frame-6,Frame-7,Frame-8,Frame-9,Frame-10,Frame-11,Frame-12,Frame-13,Frame-14,Frame-15,Frame-16,Frame-17,Frame-18,Frame-19,Frame-20,Frame-21,Frame-22,Frame-23,Frame-24,Frame-25,Frame-26",,26,0,26
065_video.mp4,"Frame-1,Frame-2,Frame-3,Frame-4,Frame-5,Frame-6,Frame-7,Frame-8,Frame-9,Frame-10,Frame-11,Frame-12,Frame-13,Frame-14,Frame-15,Frame-16,Frame-17,Frame-18,Frame-19,Frame-20,Frame-21,Frame-22,Frame-23,Frame-24,Frame-25,Frame-26,Frame-27,Frame-28,Frame-29,Frame-30",,30,0,30
066_video.mp4,"Frame-1,Frame-2,Frame-3,Frame-4,Frame-5,Frame-6,Frame-7,Frame-8,Frame-9,Frame-10,Frame-11,Frame-12,Frame-25,Frame-26,Frame-27,Frame-28,Frame-29","Frame-13,Frame-14,Frame-15,Frame-16,Frame-17,Frame-18,Frame-19,Frame-20,Frame-21,Frame-22,Frame-23,Frame-24",17,12,29
067_video.mp4,"Frame-1,Frame-2,Frame-3,Frame-4,Frame-5,Frame-6,Frame-7,Frame-8,Frame-9,Frame-10,Frame-11,Frame-12,Frame-13,Frame-14,Frame-15,Frame-16,Frame-22,Frame-23,Frame-24,Frame-25,Frame-26,Frame-27,Frame-28","Frame-17,Frame-18,Frame-19,Frame-20,Frame-21",23,5,28
068_video.mp4,"Frame-1,Frame-2,Frame-3,Frame-4,Frame-5,Frame-16,Frame-17,Frame-18,Frame-19,Frame-20,Frame-21,Frame-22,Frame-23,Frame-24,Frame-25,Frame-26","Frame-6,Frame-7,Frame-8,Frame-9,Frame-10,Frame-11,Frame-12,Frame-13,Frame-14,Frame-15",16,10,26
069_video.mp4,"Frame-1,Frame-2,Frame-3,Frame-4,Frame-5,Frame-6,Frame-7,Frame-8,Frame-9,Frame-10,Frame-11,Frame-12,Frame-13,Frame-14,Frame-15,Frame-16,Frame-19,Frame-20,Frame-21,Frame-22,Frame-23,Frame-24,Frame-25,Frame-26,Frame-27,Frame-28,Frame-29,Frame-30,Frame-31,Frame-32,Frame-33,Frame-34","Frame-17,Frame-18",32,2,34
070_video.mp4,"Frame-1,Frame-2,Frame-3,Frame-4,Frame-5,Frame-6,Frame-7,Frame-8,Frame-9,Frame-10,Frame-11,Frame-12,Frame-27,Frame-28,Frame-29,Frame-30,Frame-31,Frame-32,Frame-33,Frame-34","Frame-13,Frame-14,Frame-15,Frame-16,Frame-17,Frame-18,Frame-19,Frame-20,Frame-21,Frame-22,Frame-23,Frame-24,Frame-25,Frame-26",20,14,34
071_video.mp4,"Frame-1,Frame-2,Frame-3,Frame-4,Frame-5,Frame-6,Frame-7,Frame-8,Frame-9,Frame-10","Frame-11,Frame-12,Frame-13,Frame-14,Frame-15,Frame-16,Frame-17,Frame-18,Frame-19,Frame-20,Frame-21,Frame-22,Frame-23,Frame-24,Frame-25,Frame-26,Frame-27,Frame-28,Frame-29",10,19,29
072_video.mp4,"Frame-1,Frame-2,Frame-3,Frame-4,Frame-5,Frame-6,Frame-7,Frame-8,Frame-9,Frame-10,Frame-11,Frame-12,Frame-15,Frame-16,Frame-17,Frame-18,Frame-19,Frame-20,Frame-21,Frame-22,Frame-23,Frame-24,Frame-25,Frame-26,Frame-27,Frame-28,Frame-29,Frame-30","Frame-13,Frame-14",28,2,30
073_video.mp4,"Frame-1,Frame-2,Frame-3,Frame-4,Frame-5,Frame-6,Frame-7,Frame-8,Frame-9,Frame-10,Frame-11,Frame-12,Frame-13,Frame-14,Frame-15,Frame-16,Frame-17,Frame-18,Frame-19,Frame-20,Frame-21,Frame-22,Frame-23,Frame-24,Frame-25,Frame-32,Frame-33","Frame-26,Frame-27,Frame-28,Frame-29,Frame-30,Frame-31",27,6,33
074_video.mp4,"Frame-1,Frame-2,Frame-3,Frame-4,Frame-5,Frame-6,Frame-7,Frame-8,Frame-9,Frame-10,Frame-11,Frame-17,Frame-26,Frame-27,Frame-28,Frame-29,Frame-30,Frame-31,Frame-32,Frame-33","Frame-12,Frame-13,Frame-14,Frame-15,Frame-16,Frame-18,Frame-19,Frame-20,Frame-21,Frame-22,Frame-23,Frame-24,Frame-25",20,13,33
075_video.mp4,"Frame-1,Frame-2,Frame-3,Frame-4,Frame-5,Frame-6,Frame-7,Frame-8,Frame-9,Frame-10,Frame-11,Frame-12,Frame-13,Frame-14,Frame-15,Frame-32,Frame-33","Frame-16,Frame-17,Frame-18,Frame-19,Frame-20,Frame-21,Frame-22,Frame-23,Frame-24,Frame-25,Frame-26,Frame-27,Frame-28,Frame-29,Frame-30,Frame-31",17,16,33
076_video.mp4,"Frame-1,Frame-2,Frame-3,Frame-4,Frame-5,Frame-6,Frame-7,Frame-8,Frame-9,Frame-11,Frame-25,Frame-26,Frame-27,Frame-28,Frame-29","Frame-10,Frame-12,Frame-13,Frame-14,Frame-15,Frame-16,Frame-17,Frame-18,Frame-19,Frame-20,Frame-21,Frame-22,Frame-23,Frame-24",15,14,29
077_video.mp4,"Frame-1,Frame-2,Frame-3,Frame-4,Frame-5,Frame-6,Frame-7,Frame-8,Frame-9,Frame-22,Frame-23,Frame-24,Frame-25,Frame-26,Frame-27,Frame-28,Frame-29,Frame-30,Frame-31","Frame-10,Frame-11,Frame-12,Frame-13,Frame-14,Frame-15,Frame-16,Frame-17,Frame-18,Frame-19,Frame-20,Frame-21",19,12,31
078_video.mp4,"Frame-1,Frame-2,Frame-3,Frame-4,Frame-5,Frame-6,Frame-7,Frame-8,Frame-9,Frame-10,Frame-18,Frame-23,Frame-24,Frame-25,Frame-26,Frame-27,Frame-28,Frame-29,Frame-30,Frame-31","Frame-11,Frame-12,Frame-13,Frame-14,Frame-15,Frame-16,Frame-17,Frame-19,Frame-20,Frame-21,Frame-22",20,11,31
079_video.mp4,"Frame-1,Frame-2,Frame-3,Frame-4,Frame-5,Frame-6,Frame-7,Frame-8,Frame-9,Frame-10,Frame-11,Frame-12,Frame-13,Frame-15,Frame-16,Frame-17,Frame-18,Frame-19,Frame-20,Frame-21,Frame-22,Frame-23,Frame-24,Frame-25,Frame-26",Frame-14,25,1,26
080_video.mp4,"Frame-1,Frame-2,Frame-3,Frame-4,Frame-5,Frame-6,Frame-7,Frame-11,Frame-12,Frame-21,Frame-22,Frame-23,Frame-24,Frame-25,Frame-26,Frame-27,Frame-28,Frame-29","Frame-8,Frame-9,Frame-10,Frame-13,Frame-14,Frame-15,Frame-16,Frame-17,Frame-18,Frame-19,Frame-20",18,11,29
081_video.mp4,"Frame-1,Frame-2,Frame-3,Frame-4,Frame-5,Frame-6,Frame-7,Frame-8,Frame-9,Frame-10,Frame-11,Frame-12,Frame-28,Frame-29","Frame-13,Frame-14,Frame-15,Frame-16,Frame-17,Frame-18,Frame-19,Frame-20,Frame-21,Frame-22,Frame-23,Frame-24,Frame-25,Frame-26,Frame-27",14,15,29
082_video.mp4,"Frame-1,Frame-2,Frame-3,Frame-4,Frame-5,Frame-6,Frame-7,Frame-8,Frame-9,Frame-12,Frame-13,Frame-14,Frame-15,Frame-16,Frame-17,Frame-18,Frame-19,Frame-20,Frame-21,Frame-22,Frame-23,Frame-24,Frame-25,Frame-26,Frame-27,Frame-28,Frame-29","Frame-10,Frame-11",27,2,29
083_video.mp4,"Frame-1,Frame-2,Frame-3,Frame-4,Frame-5,Frame-6,Frame-7,Frame-8,Frame-9,Frame-10,Frame-11,Frame-12,Frame-13,Frame-14,Frame-15,Frame-16,Frame-17,Frame-18,Frame-25,Frame-26,Frame-27,Frame-28,Frame-29,Frame-30,Frame-31,Frame-32","Frame-19,Frame-20,Frame-21,Frame-22,Frame-23,Frame-24",26,6,32
084_video.mp4,"Frame-1,Frame-2,Frame-3,Frame-4,Frame-5,Frame-6,Frame-7,Frame-8,Frame-9,Frame-10,Frame-11,Frame-12,Frame-13,Frame-14,Frame-15,Frame-16,Frame-17,Frame-22,Frame-23,Frame-24,Frame-25,Frame-26,Frame-27,Frame-28,Frame-29,Frame-30,Frame-31,Frame-32,Frame-33,Frame-34,Frame-35,Frame-36","Frame-18,Frame-19,Frame-20,Frame-21",32,4,36
085_video.mp4,"Frame-1,Frame-2,Frame-3,Frame-4,Frame-5,Frame-6,Frame-7,Frame-8,Frame-9,Frame-10,Frame-11,Frame-14,Frame-15,Frame-16,Frame-17,Frame-18,Frame-19","Frame-12,Frame-13",17,2,19
086_video.mp4,"Frame-1,Frame-2,Frame-3,Frame-4,Frame-5,Frame-6,Frame-7,Frame-8,Frame-9,Frame-17,Frame-18,Frame-19,Frame-20,Frame-21,Frame-22,Frame-23,Frame-24,Frame-25,Frame-26,Frame-27,Frame-28,Frame-29","Frame-10,Frame-11,Frame-12,Frame-13,Frame-14,Frame-15,Frame-16",22,7,29
087_video.mp4,"Frame-1,Frame-2,Frame-3,Frame-4,Frame-5,Frame-6,Frame-7,Frame-8,Frame-9,Frame-10,Frame-11,Frame-12,Frame-13,Frame-14,Frame-27,Frame-28,Frame-29,Frame-30,Frame-31,Frame-32","Frame-15,Frame-16,Frame-17,Frame-18,Frame-19,Frame-20,Frame-21,Frame-22,Frame-23,Frame-24,Frame-25,Frame-26",20,12,32
088_video.mp4,"Frame-1,Frame-2,Frame-3,Frame-4,Frame-5,Frame-6,Frame-7,Frame-8,Frame-9,Frame-10,Frame-11,Frame-12,Frame-13,Frame-14,Frame-15,Frame-16,Frame-17,Frame-18,Frame-19,Frame-20,Frame-21,Frame-28,Frame-29,Frame-30,Frame-31","Frame-22,Frame-23,Frame-24,Frame-25,Frame-26,Frame-27",25,6,31
089_video.mp4,"Frame-1,Frame-2,Frame-3,Frame-4,Frame-5,Frame-6,Frame-7,Frame-8,Frame-9,Frame-10,Frame-11,Frame-12,Frame-13,Frame-14,Frame-15,Frame-16,Frame-25,Frame-26,Frame-27,Frame-28,Frame-29,Frame-30,Frame-31,Frame-32,Frame-33,Frame-34,Frame-35","Frame-17,Frame-18,Frame-19,Frame-20,Frame-21,Frame-22,Frame-23,Frame-24",27,8,35
090_video.mp4,"Frame-1,Frame-2,Frame-3,Frame-4,Frame-5,Frame-6,Frame-7,Frame-8,Frame-9,Frame-10,Frame-11,Frame-12,Frame-17,Frame-18,Frame-19,Frame-20,Frame-21,Frame-22,Frame-23,Frame-24,Frame-25,Frame-26,Frame-27,Frame-28","Frame-13,Frame-14,Frame-15,Frame-16",24,4,28
091_video.mp4,"Frame-1,Frame-2,Frame-3,Frame-4,Frame-5,Frame-6,Frame-7,Frame-8,Frame-9,Frame-10,Frame-11,Frame-12,Frame-13,Frame-14,Frame-22,Frame-23,Frame-24,Frame-25,Frame-26,Frame-27,Frame-28,Frame-29,Frame-30,Frame-31,Frame-32,Frame-33","Frame-15,Frame-16,Frame-17,Frame-18,Frame-19,Frame-20,Frame-21",26,7,33
092_video.mp4,"Frame-1,Frame-2,Frame-3,Frame-4,Frame-5,Frame-6,Frame-7,Frame-8,Frame-9,Frame-10,Frame-11,Frame-12,Frame-13,Frame-14,Frame-17,Frame-18,Frame-24,Frame-25,Frame-26,Frame-31","Frame-15,Frame-16,Frame-19,Frame-20,Frame-21,Frame-22,Frame-23,Frame-27,Frame-28,Frame-29,Frame-30",20,11,31
093_video.mp4,"Frame-1,Frame-2,Frame-3,Frame-4,Frame-5,Frame-6,Frame-7,Frame-8,Frame-9,Frame-10,Frame-11,Frame-12,Frame-13,Frame-14,Frame-15,Frame-16,Frame-17,Frame-22,Frame-23,Frame-24,Frame-25,Frame-26,Frame-27,Frame-28,Frame-29,Frame-30,Frame-31,Frame-32","Frame-18,Frame-19,Frame-20,Frame-21",28,4,32
094_video.mp4,"Frame-1,Frame-2,Frame-3,Frame-4,Frame-5,Frame-6,Frame-7,Frame-8,Frame-9,Frame-10,Frame-11,Frame-12,Frame-13,Frame-14,Frame-15,Frame-16,Frame-17,Frame-18,Frame-31,Frame-32,Frame-33,Frame-34","Frame-19,Frame-20,Frame-21,Frame-22,Frame-23,Frame-24,Frame-25,Frame-26,Frame-27,Frame-28,Frame-29,Frame-30",22,12,34
095_video.mp4,"Frame-1,Frame-2,Frame-3,Frame-4,Frame-5,Frame-6,Frame-7,Frame-8,Frame-9,Frame-10,Frame-11,Frame-12,Frame-13,Frame-14,Frame-15,Frame-16,Frame-17,Frame-18,Frame-19,Frame-20,Frame-21,Frame-22,Frame-23,Frame-24,Frame-25,Frame-26,Frame-27,Frame-28,Frame-29",,29,0,29
096_video.mp4,"Frame-1,Frame-2,Frame-3,Frame-4,Frame-5,Frame-6,Frame-7,Frame-8,Frame-9,Frame-10,Frame-11,Frame-12,Frame-13,Frame-14,Frame-15,Frame-16,Frame-17,Frame-18,Frame-19,Frame-20,Frame-21,Frame-22,Frame-23,Frame-24,Frame-25,Frame-26,Frame-27,Frame-28,Frame-29,Frame-30,Frame-31,Frame-32,Frame-33",,33,0,33
097_video.mp4,"Frame-1,Frame-2,Frame-3,Frame-4,Frame-5,Frame-6,Frame-7,Frame-8,Frame-9,Frame-10,Frame-11,Frame-12,Frame-13,Frame-14,Frame-15,Frame-25,Frame-26,Frame-27,Frame-28,Frame-29,Frame-30,Frame-31","Frame-16,Frame-17,Frame-18,Frame-19,Frame-20,Frame-21,Frame-22,Frame-23,Frame-24",22,9,31
098_video.mp4,"Frame-1,Frame-2,Frame-3,Frame-4,Frame-5,Frame-6,Frame-7,Frame-8,Frame-9,Frame-10,Frame-11,Frame-12,Frame-13,Frame-14,Frame-15,Frame-16,Frame-17,Frame-18,Frame-19,Frame-20,Frame-21,Frame-22,Frame-23,Frame-24,Frame-25,Frame-26,Frame-27,Frame-28,Frame-29",,29,0,29
099_video.mp4,"Frame-1,Frame-2,Frame-3,Frame-4,Frame-5,Frame-6,Frame-7,Frame-8,Frame-9,Frame-10,Frame-11,Frame-12,Frame-13,Frame-14,Frame-15,Frame-16,Frame-17,Frame-18,Frame-19,Frame-20,Frame-21,Frame-22,Frame-23,Frame-24,Frame-25,Frame-26,Frame-27,Frame-28,Frame-29",,29,0,29
100_video.mp4,"Frame-1,Frame-2,Frame-3,Frame-4,Frame-5,Frame-6,Frame-7,Frame-8,Frame-9,Frame-10,Frame-11,Frame-12,Frame-13,Frame-14,Frame-15,Frame-16,Frame-17,Frame-18,Frame-19,Frame-20,Frame-21,Frame-22,Frame-23,Frame-24,Frame-25,Frame-26,Frame-27,Frame-28,Frame-29,Frame-30",,30,0,30
101_video.mp4,"Frame-1,Frame-2,Frame-3,Frame-4,Frame-5,Frame-6,Frame-7,Frame-8,Frame-9,Frame-10,Frame-11,Frame-12,Frame-13,Frame-14,Frame-15,Frame-16,Frame-17,Frame-18,Frame-19,Frame-20,Frame-21,Frame-22,Frame-23,Frame-24,Frame-25,Frame-26,Frame-27,Frame-28,Frame-29,Frame-30,Frame-31",,31,0,31
102_video.mp4,"Frame-1,Frame-2,Frame-3,Frame-4,Frame-5,Frame-6,Frame-7,Frame-8,Frame-9,Frame-10,Frame-11,Frame-12,Frame-13,Frame-14,Frame-15,Frame-16,Frame-17,Frame-18,Frame-19,Frame-20,Frame-21,Frame-22,Frame-23,Frame-24,Frame-25,Frame-26,Frame-27,Frame-28,Frame-29,Frame-30,Frame-31",,31,0,31
103_video.mp4,"Frame-1,Frame-2,Frame-3,Frame-4,Frame-5,Frame-6,Frame-7,Frame-8,Frame-9,Frame-10,Frame-11,Frame-12,Frame-13,Frame-14,Frame-15,Frame-16,Frame-17,Frame-18,Frame-19,Frame-20,Frame-21,Frame-22,Frame-23,Frame-24,Frame-25,Frame-26,Frame-27,Frame-28,Frame-29,Frame-30,Frame-31,Frame-32,Frame-33,Frame-34,Frame-35",,35,0,35
104_video.mp4,"Frame-1,Frame-2,Frame-3,Frame-4,Frame-5,Frame-6,Frame-7,Frame-8,Frame-9,Frame-10,Frame-11,Frame-12,Frame-13,Frame-14,Frame-15,Frame-16,Frame-17,Frame-18,Frame-19,Frame-20,Frame-21,Frame-22,Frame-23,Frame-24,Frame-25,Frame-26,Frame-27,Frame-28,Frame-29",,29,0,29
105_video.mp4,"Frame-1,Frame-2,Frame-3,Frame-4,Frame-5,Frame-6,Frame-7,Frame-8,Frame-9,Frame-10,Frame-11,Frame-12,Frame-13,Frame-14,Frame-15,Frame-16,Frame-17,Frame-18,Frame-19,Frame-20,Frame-21,Frame-22,Frame-23,Frame-24,Frame-25,Frame-26,Frame-27,Frame-28,Frame-29,Frame-30",,30,0,30
106_video.mp4,"Frame-1,Frame-2,Frame-3,Frame-4,Frame-5,Frame-6,Frame-7,Frame-8,Frame-9,Frame-10,Frame-11,Frame-12,Frame-13,Frame-14,Frame-15,Frame-16,Frame-17,Frame-18,Frame-19,Frame-20,Frame-21,Frame-22,Frame-23,Frame-24,Frame-25,Frame-26,Frame-27,Frame-28,Frame-29",,29,0,29
107_video.mp4,"Frame-1,Frame-2,Frame-3,Frame-4,Frame-5,Frame-6,Frame-7,Frame-8,Frame-9,Frame-10,Frame-11,Frame-12,Frame-13,Frame-14,Frame-15,Frame-16,Frame-17,Frame-18,Frame-19,Frame-20,Frame-21,Frame-22,Frame-23,Frame-24,Frame-25,Frame-26,Frame-27,Frame-28,Frame-29,Frame-30",,30,0,30
108_video.mp4,"Frame-1,Frame-2,Frame-3,Frame-4,Frame-5,Frame-6,Frame-7,Frame-8,Frame-9,Frame-10,Frame-11,Frame-12,Frame-13,Frame-14,Frame-15,Frame-16,Frame-17,Frame-18,Frame-19,Frame-20,Frame-21,Frame-22,Frame-23,Frame-24,Frame-25,Frame-26,Frame-27,Frame-28,Frame-29",,29,0,29
109_video.mp4,"Frame-1,Frame-2,Frame-3,Frame-4,Frame-5,Frame-6,Frame-7,Frame-8,Frame-9,Frame-10,Frame-11,Frame-12,Frame-13,Frame-14,Frame-15,Frame-16,Frame-17,Frame-18,Frame-19,Frame-20,Frame-21,Frame-22,Frame-23,Frame-24,Frame-25,Frame-26,Frame-27,Frame-28",,28,0,28
110_video.mp4,"Frame-1,Frame-2,Frame-3,Frame-4,Frame-5,Frame-6,Frame-7,Frame-8,Frame-9,Frame-10,Frame-11,Frame-12,Frame-13,Frame-14,Frame-15,Frame-16,Frame-17,Frame-18,Frame-19,Frame-20,Frame-21,Frame-22,Frame-23,Frame-24,Frame-25,Frame-26,Frame-27,Frame-28",,28,0,28
111_video.mp4,"Frame-1,Frame-2,Frame-3,Frame-4,Frame-5,Frame-6,Frame-7,Frame-8,Frame-9,Frame-10,Frame-11,Frame-12,Frame-13,Frame-14,Frame-15,Frame-16,Frame-17,Frame-18,Frame-19,Frame-20,Frame-21,Frame-22,Frame-23,Frame-24,Frame-25,Frame-26,Frame-27,Frame-28,Frame-29,Frame-30,Frame-31,Frame-32,Frame-33",,33,0,33
112_video.mp4,"Frame-1,Frame-2,Frame-3,Frame-4,Frame-5,Frame-6,Frame-7,Frame-8,Frame-9,Frame-10,Frame-11,Frame-12,Frame-13,Frame-14,Frame-15,Frame-16,Frame-17,Frame-18,Frame-19,Frame-20,Frame-21,Frame-22,Frame-23,Frame-24,Frame-25,Frame-26",,26,0,26
113_video.mp4,"Frame-1,Frame-2,Frame-3,Frame-4,Frame-5,Frame-6,Frame-7,Frame-8,Frame-9,Frame-10,Frame-11,Frame-12,Frame-13,Frame-14,Frame-15,Frame-16,Frame-17,Frame-18,Frame-19,Frame-20,Frame-21,Frame-22,Frame-23,Frame-24,Frame-25,Frame-26,Frame-27,Frame-28",,28,0,28
114_video.mp4,"Frame-1,Frame-2,Frame-3,Frame-4,Frame-5,Frame-6,Frame-7,Frame-8,Frame-9,Frame-10,Frame-11,Frame-12,Frame-13,Frame-14,Frame-15,Frame-16,Frame-17,Frame-18,Frame-19,Frame-20,Frame-21,Frame-22,Frame-23,Frame-24,Frame-25,Frame-26,Frame-27,Frame-28,Frame-29",,29,0,29
115_video.mp4,"Frame-1,Frame-2,Frame-3,Frame-4,Frame-5,Frame-6,Frame-7,Frame-8,Frame-9,Frame-10,Frame-11,Frame-12,Frame-13,Frame-14,Frame-15,Frame-16,Frame-17,Frame-18,Frame-19,Frame-20,Frame-21,Frame-22,Frame-23,Frame-24,Frame-25,Frame-26,Frame-27,Frame-28,Frame-29,Frame-30,Frame-31,Frame-32",,32,0,32
116_video.mp4,"Frame-1,Frame-2,Frame-3,Frame-4,Frame-5,Frame-6,Frame-7,Frame-8,Frame-9,Frame-10,Frame-11,Frame-12,Frame-13,Frame-14,Frame-15,Frame-16,Frame-17,Frame-18,Frame-19,Frame-20,Frame-21,Frame-22,Frame-23,Frame-24,Frame-25,Frame-26,Frame-27,Frame-28,Frame-29,Frame-30,Frame-31",,31,0,31
117_video.mp4,"Frame-1,Frame-2,Frame-3,Frame-4,Frame-5,Frame-6,Frame-7,Frame-8,Frame-9,Frame-10,Frame-11,Frame-12,Frame-13,Frame-14,Frame-15,Frame-16,Frame-17,Frame-18,Frame-19,Frame-20,Frame-21,Frame-22,Frame-23,Frame-24,Frame-25,Frame-26,Frame-27,Frame-28,Frame-29",,29,0,29
118_video.mp4,"Frame-1,Frame-2,Frame-3,Frame-4,Frame-5,Frame-6,Frame-7,Frame-8,Frame-9,Frame-10,Frame-11,Frame-12,Frame-13,Frame-14,Frame-15,Frame-16,Frame-17,Frame-18,Frame-19,Frame-20,Frame-21,Frame-22,Frame-23,Frame-24,Frame-25,Frame-26,Frame-27,Frame-28,Frame-29,Frame-30",,30,0,30
119_video.mp4,"Frame-1,Frame-2,Frame-3,Frame-4,Frame-5,Frame-6,Frame-7,Frame-8,Frame-9,Frame-10,Frame-11,Frame-12,Frame-13,Frame-14,Frame-15,Frame-16,Frame-17,Frame-18,Frame-19,Frame-20,Frame-21,Frame-22,Frame-23,Frame-24,Frame-25,Frame-26,Frame-27,Frame-28,Frame-29,Frame-30,Frame-31",,31,0,31
120_video.mp4,"Frame-1,Frame-2,Frame-3,Frame-4,Frame-5,Frame-6,Frame-7,Frame-8,Frame-9,Frame-10,Frame-11,Frame-12,Frame-13,Frame-14,Frame-15,Frame-16,Frame-17,Frame-18,Frame-19,Frame-20,Frame-21,Frame-22,Frame-23,Frame-24,Frame-25,Frame-26,Frame-27,Frame-28,Frame-29,Frame-30",,30,0,30
121_video.mp4,"Frame-1,Frame-2,Frame-3,Frame-4,Frame-5,Frame-6,Frame-7,Frame-8,Frame-9,Frame-10,Frame-11,Frame-12,Frame-13,Frame-14,Frame-15,Frame-16,Frame-17,Frame-18,Frame-19,Frame-20,Frame-21,Frame-22,Frame-23,Frame-24,Frame-25,Frame-26,Frame-27,Frame-28,Frame-29,Frame-30",,30,0,30
122_video.mp4,"Frame-1,Frame-2,Frame-3,Frame-4,Frame-5,Frame-6,Frame-7,Frame-8,Frame-9,Frame-10,Frame-11,Frame-12,Frame-13,Frame-14,Frame-15,Frame-16,Frame-17,Frame-18,Frame-19,Frame-20,Frame-21,Frame-22,Frame-23,Frame-24,Frame-25,Frame-26,Frame-27,Frame-28",,28,0,28
123_video.mp4,"Frame-1,Frame-2,Frame-3,Frame-4,Frame-5,Frame-6,Frame-7,Frame-8,Frame-9,Frame-10,Frame-11,Frame-12,Frame-13,Frame-14,Frame-15,Frame-16,Frame-17,Frame-18,Frame-19,Frame-20,Frame-21,Frame-22,Frame-23,Frame-24,Frame-25,Frame-26,Frame-27,Frame-28,Frame-29,Frame-30,Frame-31,Frame-32,Frame-33,Frame-34,Frame-35,Frame-36,Frame-37,Frame-38,Frame-39",,39,0,39
124_video.mp4,"Frame-1,Frame-2,Frame-3,Frame-4,Frame-5,Frame-6,Frame-7,Frame-8,Frame-9,Frame-10,Frame-11,Frame-12,Frame-13,Frame-14,Frame-15,Frame-16,Frame-17,Frame-18,Frame-19,Frame-20,Frame-21,Frame-22,Frame-23,Frame-24,Frame-25,Frame-26,Frame-27,Frame-28,Frame-29,Frame-30",,30,0,30
125_video.mp4,"Frame-1,Frame-2,Frame-3,Frame-4,Frame-5,Frame-6,Frame-7,Frame-8,Frame-9,Frame-10,Frame-11,Frame-12,Frame-13,Frame-14,Frame-15,Frame-16,Frame-17,Frame-18,Frame-19,Frame-20,Frame-21,Frame-22,Frame-23,Frame-24,Frame-25,Frame-26,Frame-27,Frame-28,Frame-29,Frame-30,Frame-31,Frame-32,Frame-33,Frame-34,Frame-35,Frame-36,Frame-37,Frame-38,Frame-39,Frame-40",,40,0,40
126_video.mp4,"Frame-1,Frame-2,Frame-3,Frame-4,Frame-5,Frame-6,Frame-7,Frame-8,Frame-9,Frame-10,Frame-11,Frame-12,Frame-13,Frame-14,Frame-15,Frame-16,Frame-17,Frame-18,Frame-19,Frame-20,Frame-21,Frame-22,Frame-23,Frame-24,Frame-25,Frame-26,Frame-27,Frame-28,Frame-29,Frame-30",,30,0,30
127_video.mp4,"Frame-1,Frame-2,Frame-3,Frame-4,Frame-5,Frame-6,Frame-7,Frame-8,Frame-9,Frame-10,Frame-11,Frame-12,Frame-13,Frame-14,Frame-15,Frame-16,Frame-17,Frame-18,Frame-19,Frame-20,Frame-21,Frame-22,Frame-23,Frame-24,Frame-25,Frame-26,Frame-27,Frame-28,Frame-29,Frame-30,Frame-31,Frame-32",,32,0,32
128_video.mp4,"Frame-1,Frame-2,Frame-3,Frame-4,Frame-5,Frame-6,Frame-7,Frame-8,Frame-9,Frame-10,Frame-11,Frame-12,Frame-13,Frame-14,Frame-15,Frame-16,Frame-17,Frame-18,Frame-19,Frame-20,Frame-21,Frame-22,Frame-23,Frame-24,Frame-25,Frame-26,Frame-27,Frame-28",,28,0,28
129_video.mp4,"Frame-1,Frame-2,Frame-3,Frame-4,Frame-5,Frame-6,Frame-7,Frame-8,Frame-9,Frame-10,Frame-11,Frame-12,Frame-13,Frame-14,Frame-15,Frame-16,Frame-17,Frame-18,Frame-19,Frame-20,Frame-21,Frame-22,Frame-23,Frame-24,Frame-25,Frame-26,Frame-27,Frame-28,Frame-29,Frame-30",,30,0,30
130_video.mp4,"Frame-1,Frame-2,Frame-3,Frame-4,Frame-5,Frame-6,Frame-7,Frame-8,Frame-9,Frame-10,Frame-11,Frame-12,Frame-13,Frame-14,Frame-15,Frame-16,Frame-17,Frame-18,Frame-19,Frame-20,Frame-21,Frame-22,Frame-23,Frame-24,Frame-25,Frame-26,Frame-27,Frame-28,Frame-29,Frame-30,Frame-31",,31,0,31
